R 640 480

NO ./pics/AnyConv.com__redbrick.xpm
SO ./pics/AnyConv.com__bluestone.xpm
WE ./pics/AnyConv.com__greystone.xpm
EA ./pics/AnyConv.com__wood.xpm
S  ./pics/AnyConv.com__barrel.xpm

F 255, 255, 255
C 200, 100, 100

11111111111111111111111111111111
100000000000000000000001
1011111111111111111111111
1000010000000000000000011
10000000010000100000001
10000000000000020002001
10000000100100000000001
10000000000000222200001
10000000000000000000    001
100000000000002022000001
1000000000N0000000000001
100000000000000000000001
100000000000111000000011
1000000000001 1000000001
1000000000001 1000000001
1111111111111 1111111111