R 640 480

NO ./pics/AnyConv.com__redbrick.xpm
SO ./pics/AnyConv.com__bluestone.xpm
WE ./pics/AnyConv.com__greystone.xpm
EA ./pics/AnyConv.com__wood.xpm
S  ./pics/AnyConv.com__barrel.xpm

F 255, 255, 255
C 200, 100, 100


111111111111111111111111
111111110000000000000011
100000200001000000000 01
100000000000000002000 01
100000000100001000000 01
100000000000000200020 01
100000001001000000000 01
100000000000002222000 01
100000000000000000000 01
100000000000002022000001
1000000000N0000000000001
100000000000000000000001
100000000000111000000011
1000000000001 1000000001
1000000000001 1000000001
1111111111111 1111111111