R 640 480

NO ./pics/AnyConv.com__redbrick.xpm
SO ./pics/AnyConv.com__bluestone.xpm
WE ./pics/AnyConv.com__greystone.xpm
EA ./pics/AnyConv.com__wood.xpm
S  ./pics/AnyConv.com__barrel.xpm

F 128, 128, 128
C 70, 70, 255

        1111111111111111111111111
        1110000000110000000000001
        1000000000110000000000001
        1000000000110000002000001
        1000000000110000000000001
111111111000000000000000000000001
100000000000000000000200001111111
10000111111110001100000000001
10000111111110001100000000001
1100000011110000110000020000111
1000200000000000110000000000001
1000000000000000110000E00000111
1100000111010101110000000000111
11110111 1110101 10000000000001
11111111 1111111 11111111111111