1111111111111111111111111
1000000000110000000000001
1011000001110000000000001
1001000000000000000000001
11011111101100000111000001
1000000000110000011101111111
11110101111111011100000000001
11110101111111011101010010001
11000000110101011100000010001
10000000000000001100000010001
10000000000000001101010010001
11000001110101000000011110N01
11111111111111111111111111111