111111111111111111111111
100000000011000000000001
101100000111000000000001
100100000000000000000001
110111111011000001110001
100000000011000001110111
111101011111110111000001
111101011111110111010101
110000001101010111000001
100000000W00000011000001
110000011101010000000111
100000000011000000000001
101100000111000000000001
100100000000000000000001
110111111011000001110001
100000000011000001110111
111101011111110111000001
111101011111110111010101
110000001101010111000001
100000000000001011000001
110000011101010000000111
100000000010000001100001
110000011101010000000111
111111111111111111111111