1111111
1010101
1010101
1000001
101N101
1111111