R 640 480

NO ./pics/AnyConv.com__redbrick.xpm
SO ./pics/AnyConv.com__bluestone.xpm
WE ./pics/AnyConv.com__greystone.xpm
EA ./pics/AnyConv.com__wood.xpm
S  ./pics/AnyConv.com__barrel.xpm

F 50,   200,     200
C 200, 100, 50


111111111111111111111111
100000000011000000000001
101100000111000000000001
100100000000000000000001
110111111011000001110001
100000000011000001110111
111101011111110111000001
111101011111110111010101
110000001101010111000001
100000000100000011000001
110000011101010000000111
100000000011000000000001
101100000111000N00000001
100100000000000000000001
110111111011000001110001
100000000011000001110001
111111111111111111111111