R 640 480

NO ./pics/AnyConv.com__redbrick.xpm
SO ./pics/AnyConv.com__bluestone.xpm
WE ./pics/AnyConv.com__greystone.xpm
EA ./pics/AnyConv.com__wood.xpm
S  ./pics/AnyConv.com__barrel.xpm

F 50, 0, 0
C 100, 100, 100

        111111111111111111111111
111111110000000000000001
100000200001000000000001
100000000000000002000001
100000000100001000000001
10000000000000020N0200001
100000000001000000000001
100000000000002222000001
100000000000000000000001
100000000000000000000001
100000000000000000000001
100000000000000000000001
100000000000111000000001
1000000000001 1000000001
1000000000001 1000000001
1111111111111 1111111111